#####################
#S       #          #
# ###### # ###### ###
# #   #    #        #
# # #### ##### # ## #
# # #  #   # # #    #
# # ###### # # #### #
#    # #   #   ######
#### ####### ###    #
####  ######     ##F#
#####################